18 18 18 18 18 18 18 18 18 18 18 18 18 18 18 18 18 18 18 18 18 18 18 18 18 18 18 18 18 18 18 18 18 18 18 18 18 18 18 18 18 18 18 18 18 18 18 18 18 18 18 18 18 18 18 18 18 18 18 18 18 18 18 18 18 18 18 18 18 18 18 18 18 18 18 18 18 18 18 18 18 18 18 18 18 18 18 18 18 18 18 18 18 18 18 18 18 18 18 18 
18 18 18 18 18 18 18 18 18 19 18 18 18 18 18 18 18 18 18 18 18 18 18 18 18 18 18 18 18 18 18 18 18 18 18 18 18 18 18 18 18 18 18 18 18 18 18 18 18 18 18 18 18 18 18 18 18 18 18 19 18 18 18 18 18 18 18 18 18 18 18 18 18 18 18 18 18 18 18 18 18 18 18 18 18 18 18 18 18 18 18 18 18 18 18 18 18 18 18 18 
18 18 18 18 18 18 18 18 18 18 18 18 18 18 18 18 18 18 18 18 18 18 18 18 18 18 18 18 18 18 18 18 18 18 18 18 18 18 18 18 18 18 18 18 18 18 18 18 18 18 18 18 18 18 18 18 18 18 18 18 18 18 18 18 18 18 18 18 18 18 18 18 18 18 18 18 18 18 18 18 18 18 18 18 18 18 18 18 18 18 18 18 18 18 18 18 18 18 18 18 
18 18 18 19 18 18 18 18 18 18 18 18 18 18 18 18 18 18 18 18 18 18 18 18 18 18 18 19 18 18 18 18 18 18 18 19 18 18 18 18 18 18 18 18 18 18 18 18 18 18 18 18 18 19 18 18 18 18 18 18 18 18 18 18 18 18 18 18 18 18 18 18 18 18 18 18 18 19 18 18 18 18 18 18 18 19 18 18 18 18 18 18 18 18 18 18 18 18 18 18 
18 18 18 18 18 18 19 18 18 18 18 18 18 18 18 18 18 19 18 18 18 18 19 18 18 18 18 18 18 18 18 18 18 18 18 18 18 18 18 18 18 18 18 18 18 18 18 18 18 18 18 18 18 18 18 18 19 18 18 18 18 18 18 18 18 18 18 19 18 18 18 18 19 18 18 18 18 18 18 18 18 18 18 18 18 18 18 18 18 18 18 18 18 18 18 18 18 18 18 18 
18 18 18 18 18 18 18 18 18 18 18 18 19 18 18 18 18 18 18 18 18 18 18 18 18 18 18 18 18 19 18 19 18 18 18 18 18 18 18 18 18 18 18 18 18 18 18 18 18 18 18 18 18 18 18 18 18 18 18 18 18 18 19 18 18 18 18 18 18 18 18 18 18 18 18 18 18 18 18 19 18 19 18 18 18 18 18 18 18 18 18 18 18 18 18 18 18 18 18 18 
18 18 18 18 18 18 18 18 28 26 26 26 26 26 26 26 29 18 28 26 26 26 26 26 26 26 26 29 18 18 18 28 26 26 26 26 26 26 26 26 26 26 26 26 26 26 26 26 26 26 26 26 26 26 26 26 26 26 26 26 26 26 26 26 26 26 29 18 28 26 26 26 26 26 26 26 26 29 18 18 18 28 26 26 26 26 26 26 26 26 26 26 29 18 18 18 18 18 18 18 
18 19 18 18 18 18 18 18 24 16 32 32 32 32 32 16 25 26 27 16 1 1 1 1 1 1 1 25 26 26 26 27 16 1 12 10 10 10 10 10 10 13 1 1 1 1 12 10 10 13 1 1 2 2 16 16 2 2 2 16 32 32 32 32 32 2 25 26 27 2 1 1 1 1 1 1 1 25 26 26 26 27 1 1 12 10 10 10 10 10 10 13 23 18 18 19 18 18 18 18
18 18 18 18 18 18 18 18 24 16 32 17 17 17 32 2 16 2 2 16 1 20 21 22 1 1 1 2 2 2 2 16 2 1 8 3 3 3 3 3 3 9 10 10 10 10 11 3 3 7 1 2 2 2 2 2 2 2 2 2 32 17 17 17 32 2 2 2 2 2 2 20 21 21 21 22 1 2 16 1 2 2 2 1 8 3 3 3 3 3 3 7 23 18 18 18 18 18 18 18
18 18 18 18 18 18 18 18 24 2 32 17 36 17 32 2 2 2 2 2 1 25 26 27 1 1 1 16 2 2 2 2 2 2 8 3 3 3 3 3 3 3 3 3 3 3 3 3 3 7 1 2 2 2 2 2 2 2 2 2 32 17 36 17 32 2 2 2 2 2 1 23 18 18 18 24 1 2 2 2 1 1 1 1 8 3 3 3 3 3 3 7 23 18 18 18 18 19 18 18
18 18 18 18 18 18 18 18 24 2 32 17 17 17 32 2 2 2 2 2 2 1 1 1 1 1 1 2 2 2 2 2 2 2 8 3 3 3 3 3 3 3 3 3 3 3 3 3 3 7 1 2 1 2 2 2 2 2 2 2 32 17 17 17 32 16 2 2 2 16 1 23 18 18 18 24 1 2 2 2 1 1 1 1 8 3 3 3 3 3 3 7 23 19 18 18 18 18 18 18
18 18 19 18 18 18 18 18 24 2 32 17 17 17 32 2 2 2 2 2 1 1 1 1 1 1 1 1 2 2 2 2 2 2 8 3 3 3 3 3 3 3 3 3 4 5 5 5 5 15 1 1 1 1 1 1 2 2 2 2 32 17 17 17 32 2 2 2 2 2 1 25 26 26 26 27 1 2 2 2 16 2 16 16 8 3 3 3 3 3 3 7 23 18 18 18 18 18 18 18
18 18 18 18 18 19 18 18 24 2 32 32 17 32 32 1 1 1 1 2 2 1 12 10 13 1 1 2 2 2 2 2 2 2 14 5 5 6 3 4 5 5 5 5 15 1 1 1 1 1 1 1 1 1 1 1 2 2 2 2 32 32 17 32 32 2 2 2 2 2 2 1 12 10 13 1 1 2 1 2 2 1 1 1 14 5 5 6 3 4 5 15 23 18 18 18 18 18 18 18
18 18 18 18 18 18 18 18 24 2 2 16 1 16 2 2 2 2 1 2 1 1 8 3 7 16 2 2 2 2 2 1 1 2 2 2 1 8 3 7 1 2 1 1 1 1 1 1 1 1 1 1 1 1 1 1 2 2 2 2 2 2 2 2 2 2 2 2 2 2 2 2 8 3 7 1 1 1 2 1 2 2 2 2 2 2 16 8 3 7 20 21 31 18 18 18 19 18 18 18
18 18 18 18 18 18 18 18 30 22 2 2 1 1 2 2 2 2 1 1 1 2 8 3 7 2 2 2 1 1 1 1 1 2 2 2 2 8 3 7 20 21 21 21 21 22 1 1 1 1 1 1 1 1 1 1 1 2 2 2 2 2 2 2 2 2 2 2 2 2 2 2 8 3 7 16 2 2 2 2 2 2 2 2 2 2 2 8 3 7 23 18 18 18 18 18 18 18 18 18
18 19 18 18 18 18 18 19 18 24 2 2 1 1 1 1 1 1 1 2 1 2 8 3 7 2 2 1 1 2 2 2 1 2 2 2 2 8 3 7 23 19 18 19 18 24 1 1 1 1 1 1 1 1 1 1 1 2 2 2 2 2 2 2 2 2 2 2 2 2 2 2 8 3 7 2 2 2 2 2 2 16 2 2 2 2 2 8 3 7 23 19 18 18 18 18 18 18 18 18
18 18 18 18 18 18 18 18 28 27 16 1 1 2 1 2 2 2 1 1 1 2 8 3 7 1 1 1 1 1 1 1 1 2 2 2 2 8 3 7 23 18 18 19 18 24 1 1 1 1 1 1 1 1 1 1 1 1 1 2 2 2 2 2 2 2 2 2 2 16 1 2 8 3 7 2 2 2 2 2 2 2 2 2 2 2 2 8 3 7 23 18 18 19 18 18 18 18 18 18
18 18 18 18 18 18 18 28 27 1 1 1 1 2 1 2 2 2 1 1 2 1 8 3 7 1 1 1 1 1 1 1 1 1 1 12 10 11 3 7 25 26 26 26 26 27 1 1 1 1 1 1 1 1 1 1 1 16 1 2 2 2 2 2 2 2 2 2 2 2 1 2 8 3 7 2 2 2 2 2 2 2 2 2 2 2 10 11 3 7 23 18 18 18 18 18 18 18 18 18
18 18 18 18 18 18 18 24 16 1 1 1 1 1 1 1 2 2 16 1 2 1 8 3 7 1 1 1 1 1 1 1 1 2 1 8 3 3 3 7 2 2 2 2 2 1 1 1 1 1 1 1 1 1 1 1 1 1 1 1 1 2 2 2 2 2 2 2 2 2 2 2 8 3 7 2 2 2 2 2 2 2 2 2 2 8 3 3 3 7 23 18 18 18 18 18 19 18 18 18
18 18 18 18 18 19 18 24 2 2 1 1 1 16 1 1 2 2 2 2 2 1 8 3 7 1 1 2 2 2 1 1 1 1 1 8 3 4 5 15 1 1 2 2 2 1 1 1 1 1 1 1 1 1 1 1 1 1 1 1 2 2 2 2 1 1 1 2 2 2 1 1 8 3 7 1 1 2 2 2 2 2 2 2 16 8 3 4 5 15 23 18 18 18 18 18 18 18 18 18
18 18 18 18 18 18 18 24 1 1 1 1 1 1 2 10 10 10 10 10 10 10 11 3 9 10 10 10 10 13 2 2 2 12 10 11 3 7 1 1 1 1 1 1 1 1 1 1 1 1 1 1 1 1 1 1 1 1 2 2 2 1 1 1 12 10 10 10 10 10 10 10 11 3 9 10 10 10 10 13 2 2 2 12 10 11 3 7 1 16 23 18 18 19 18 18 18 18 18 18
18 18 18 19 18 18 18 24 1 1 1 16 1 1 8 3 3 3 3 3 3 3 3 3 3 3 3 3 3 7 2 1 2 8 3 3 3 7 1 1 1 1 1 1 1 1 1 1 1 1 1 1 1 1 1 1 1 1 2 1 1 1 1 1 8 3 3 3 3 3 3 3 3 3 3 3 3 3 3 7 2 2 2 8 3 3 3 7 1 20 31 18 18 18 18 18 18 18 18 18
18 18 18 18 18 18 18 24 16 1 1 1 1 1 14 5 5 5 5 5 5 5 6 3 4 5 5 5 5 15 1 1 2 14 5 6 3 7 2 1 1 1 1 1 1 1 1 1 1 1 1 1 1 1 1 1 1 1 16 1 2 2 1 1 14 5 5 5 5 5 5 5 6 3 4 5 5 5 5 15 1 2 2 14 5 6 3 7 2 23 18 18 19 18 18 18 18 18 18 18
18 18 18 18 18 18 18 30 22 1 1 1 1 1 1 1 2 2 1 1 1 1 8 3 7 1 16 1 1 1 1 2 2 16 2 8 3 7 1 1 1 1 1 1 1 1 1 1 1 1 1 1 1 1 1 1 1 1 1 1 1 2 2 2 1 1 1 1 2 2 2 2 8 3 7 1 2 2 2 2 2 2 1 1 1 8 3 7 1 23 18 18 18 18 18 18 18 18 18 18
18 18 18 18 18 18 18 18 24 1 1 2 1 1 1 2 2 2 2 2 2 2 8 3 7 2 2 1 1 1 1 2 2 2 2 8 3 7 1 1 1 1 1 1 1 1 1 1 1 1 1 1 1 1 1 1 1 1 1 1 1 1 1 1 2 2 1 1 2 2 2 2 8 3 7 1 1 1 1 1 2 2 2 1 1 8 3 7 1 23 18 18 18 18 18 18 18 18 18 18
18 18 18 18 18 18 18 28 27 1 1 2 1 2 2 2 2 2 2 2 2 2 8 3 7 2 2 2 2 2 2 2 2 2 2 8 3 7 1 1 1 1 1 1 1 1 1 1 1 1 1 1 1 1 1 1 1 1 1 1 1 1 1 1 1 1 1 1 1 2 1 2 8 3 7 1 1 2 2 2 2 2 2 1 1 8 3 7 1 23 18 18 18 18 18 18 19 18 18 18
18 18 18 19 18 18 18 24 16 1 1 2 1 2 2 2 2 2 2 2 2 2 8 3 7 16 2 2 2 2 2 2 2 2 2 8 3 7 1 1 1 1 1 1 1 1 1 1 1 1 1 1 1 1 1 1 1 1 1 1 1 1 2 2 2 2 1 2 1 1 1 2 8 3 7 16 1 2 2 2 2 2 2 1 1 8 3 7 1 23 18 18 18 18 18 18 18 18 18 18
18 18 18 18 18 18 18 24 1 1 1 1 1 2 1 2 2 2 2 2 2 2 8 3 7 1 2 2 2 2 2 2 2 2 2 8 3 7 1 1 1 1 1 1 1 1 1 1 1 1 1 1 1 1 1 1 1 1 16 1 1 2 1 1 1 1 1 2 1 1 2 2 8 3 7 1 1 2 16 2 2 2 2 2 2 8 3 7 1 23 18 18 18 18 18 18 18 18 18 18
18 18 18 18 18 18 18 24 1 1 1 1 1 2 1 2 2 2 2 2 2 2 8 3 7 2 2 2 2 2 2 2 2 2 2 8 3 7 1 1 1 1 1 1 1 1 1 1 1 1 1 1 1 1 1 1 1 1 2 1 1 1 1 2 1 1 2 2 1 1 2 2 8 3 7 2 2 2 2 2 2 2 1 1 2 8 3 7 1 23 18 18 19 18 18 18 18 18 18 18
18 18 19 18 18 18 18 24 1 1 1 1 1 1 1 1 12 10 10 10 10 10 11 3 7 2 1 2 2 2 1 2 2 2 2 14 5 15 1 1 1 1 1 1 1 1 1 1 1 1 1 1 1 1 1 1 1 1 1 1 1 1 1 1 1 1 1 1 1 2 2 2 8 3 7 2 2 1 2 2 2 1 1 1 2 2 5 15 1 23 18 18 18 18 18 18 18 18 18 18
18 18 18 18 18 18 18 24 16 1 1 2 1 1 1 1 8 3 3 3 3 3 3 3 7 2 1 1 2 1 1 2 2 2 2 2 2 2 2 1 1 1 1 1 1 1 1 1 1 1 1 1 1 1 1 1 1 1 1 2 1 1 1 1 1 1 2 2 2 2 2 1 8 3 7 2 2 2 33 2 2 1 1 1 2 2 1 16 20 31 18 18 18 18 18 18 18 18 18 18
18 18 18 18 18 18 19 30 22 2 1 1 1 1 1 1 8 3 4 5 5 5 6 3 7 2 1 1 2 1 1 16 2 2 2 2 2 1 1 1 1 1 1 1 1 1 1 1 1 1 1 1 1 1 1 1 1 1 1 1 1 1 1 1 1 2 2 2 33 2 2 2 8 3 7 1 1 1 1 2 2 1 1 1 2 16 1 1 23 18 19 18 18 18 18 18 18 18 18 18
18 18 18 18 18 18 18 18 24 2 2 2 1 2 1 1 8 3 9 13 2 2 8 3 7 2 1 2 1 1 2 2 2 2 2 2 2 1 1 1 1 1 1 1 1 1 1 1 1 1 1 1 1 1 1 1 1 1 2 1 1 2 2 2 2 33 2 2 2 2 2 2 8 3 7 1 1 2 1 2 1 1 1 1 16 1 1 1 23 18 18 18 18 18 18 18 18 19 18 18
18 18 18 18 18 18 18 18 24 2 2 1 1 1 1 8 3 3 3 7 2 2 8 3 7 2 1 2 1 2 2 2 2 2 2 2 1 2 1 1 1 1 1 1 1 1 1 1 1 1 1 1 1 1 1 1 1 1 2 2 2 2 1 1 2 2 2 2 2 2 2 2 8 3 7 2 1 1 1 1 1 2 1 2 2 1 1 2 23 18 18 18 18 18 18 18 18 18 18 18
18 18 18 18 19 18 18 18 24 16 2 2 1 1 1 8 3 33 3 7 2 2 8 3 7 1 1 1 2 1 2 2 2 2 2 2 1 1 1 1 1 1 1 16 16 1 1 1 1 1 1 1 1 1 1 1 1 1 2 2 2 2 2 2 2 1 2 2 2 2 2 2 8 3 7 2 16 2 1 1 2 2 1 1 2 1 1 1 23 18 18 18 18 18 18 18 18 18 18 18
18 18 18 18 18 18 18 28 27 1 2 2 1 2 2 8 3 3 3 7 16 2 14 5 15 1 1 2 2 1 2 2 2 2 2 1 1 1 1 1 1 1 1 16 16 1 1 1 1 1 1 1 1 1 1 1 1 1 1 1 1 1 1 2 2 2 2 2 2 1 2 2 14 5 15 2 2 2 2 1 2 2 1 1 1 1 1 1 25 29 18 18 18 18 18 18 18 18 18 18
18 18 18 18 18 18 18 24 1 1 1 1 2 2 2 14 5 5 5 15 1 1 1 1 1 1 1 2 1 1 2 2 2 2 2 1 1 1 1 1 1 1 1 1 1 1 1 1 1 1 1 1 1 1 1 1 1 1 2 2 2 2 1 2 2 2 1 16 1 2 2 2 1 2 2 1 2 2 1 1 1 1 1 1 1 1 1 1 1 25 29 18 18 19 18 18 18 18 18 18
18 18 18 18 18 18 18 24 1 1 1 1 2 2 2 2 2 2 2 1 1 1 1 2 1 1 1 1 1 1 1 1 1 1 1 2 1 1 1 1 1 1 1 1 1 1 1 1 1 1 1 1 1 1 1 1 1 1 2 1 1 1 1 2 2 2 1 1 1 1 2 1 1 2 1 1 1 2 1 1 1 1 1 1 1 2 1 1 1 1 23 18 18 18 18 18 18 18 18 18
18 18 18 18 18 18 18 24 1 1 1 2 2 2 2 2 2 2 2 1 1 1 1 1 1 1 1 1 2 2 1 1 1 1 1 1 1 1 1 1 1 1 1 1 1 1 1 1 1 16 1 1 1 1 1 1 1 1 1 1 16 1 1 1 16 1 1 1 2 2 2 1 1 1 1 1 1 1 1 1 1 1 1 1 1 1 1 1 1 1 23 18 18 18 18 18 18 18 18 18
18 18 18 18 18 18 18 24 1 1 33 1 1 1 1 2 2 2 2 1 1 1 1 1 1 1 2 1 2 2 2 2 2 2 2 1 1 1 1 2 1 1 1 1 1 1 1 1 1 1 1 1 1 1 1 1 2 1 1 16 1 1 1 1 1 1 1 2 2 1 1 1 1 1 1 1 2 1 1 1 1 1 1 1 1 1 1 16 1 2 23 18 18 18 18 18 18 18 18 18
18 18 18 18 18 19 18 24 1 1 1 1 1 1 1 1 1 1 2 2 2 1 1 1 16 1 1 1 1 1 1 1 1 1 2 2 1 1 1 1 1 1 1 1 1 1 1 1 1 1 1 1 1 1 2 2 2 2 1 1 1 1 1 1 1 1 1 1 2 1 1 1 1 1 1 1 1 1 1 1 1 1 1 1 1 1 1 1 1 1 23 18 18 18 18 18 18 18 18 18
18 18 18 18 18 18 18 24 1 1 1 1 1 1 1 20 22 2 2 2 1 1 1 1 1 1 1 20 21 21 22 1 1 1 1 1 1 1 1 1 1 1 1 1 1 1 1 1 1 1 1 1 1 1 1 2 2 2 1 1 1 1 1 1 1 20 21 21 22 1 1 1 1 1 1 1 1 20 21 21 22 1 1 1 1 1 1 1 1 1 23 18 18 18 18 18 18 18 18 18
18 19 18 18 18 18 18 24 16 1 16 1 1 1 20 31 24 2 2 2 2 1 1 1 1 1 20 31 28 26 27 1 1 16 1 1 16 1 1 1 1 1 1 1 1 1 1 1 1 1 1 1 1 1 1 1 2 2 1 1 1 1 1 1 1 25 26 26 27 2 1 1 1 1 1 1 20 31 18 18 24 1 1 16 1 1 16 1 1 1 25 26 26 26 29 18 19 18 18 18
18 18 18 18 18 18 18 30 21 21 21 21 21 21 31 18 24 2 2 2 2 2 2 2 20 21 31 28 27 2 2 2 1 1 1 1 1 1 20 21 21 22 1 1 2 1 1 1 1 1 1 1 1 1 1 2 2 2 1 1 1 1 1 1 1 1 1 1 1 1 1 1 1 1 1 1 23 18 18 28 27 1 1 1 1 1 1 1 1 1 1 1 1 1 23 18 18 18 18 18
18 18 18 18 18 18 18 18 18 18 18 18 18 18 19 18 24 2 2 16 2 2 2 2 25 26 26 27 2 2 2 2 2 2 2 2 2 2 23 18 18 24 1 1 2 2 1 1 1 1 1 1 1 1 33 2 2 2 1 1 1 1 1 1 1 1 1 1 1 1 1 1 1 1 1 1 23 18 19 24 1 1 1 1 1 1 1 1 1 1 1 1 1 1 23 18 18 18 18 18
18 18 18 18 19 18 18 18 18 18 18 18 18 18 28 26 27 2 2 2 2 2 2 1 1 1 1 1 1 1 1 1 1 1 1 2 2 2 23 19 18 24 1 1 2 2 1 1 1 1 1 1 1 1 1 2 2 2 1 1 1 1 1 1 1 1 1 1 1 1 1 1 1 1 1 1 25 26 26 27 1 1 1 1 1 1 1 1 1 1 1 1 1 1 23 18 18 18 18 18
18 18 18 18 18 18 18 18 18 19 18 18 18 18 24 2 2 2 2 2 2 2 2 1 1 1 1 1 1 1 1 1 1 1 1 2 2 2 23 18 18 24 2 2 2 1 1 1 1 1 1 1 1 1 1 2 2 1 1 1 1 1 1 1 1 1 1 1 1 1 1 1 1 1 1 1 1 1 1 1 1 1 1 1 1 1 1 1 1 33 1 1 1 20 31 19 18 18 18 18
18 18 18 18 18 18 18 18 18 18 18 18 18 18 24 2 2 2 2 2 2 2 2 2 1 1 1 1 1 1 1 2 1 1 1 2 2 2 25 26 26 27 2 1 1 1 1 1 1 1 1 2 1 1 1 1 1 1 1 1 1 1 1 1 1 1 1 1 1 1 1 1 1 1 1 1 1 1 1 1 1 1 1 1 1 1 1 1 1 1 1 1 1 23 18 18 18 18 18 18
18 18 18 18 18 18 18 18 18 18 18 18 18 18 24 2 2 2 2 2 2 2 2 2 1 1 1 1 33 1 1 1 1 2 2 33 2 2 2 1 1 1 2 2 2 2 1 2 2 1 1 1 2 1 2 1 1 2 1 1 1 1 1 1 1 1 1 1 1 1 1 1 1 1 1 1 1 1 1 1 1 1 1 1 1 1 1 1 1 1 1 1 1 23 18 18 18 18 18 18
18 18 18 18 18 18 18 18 18 18 18 18 18 18 24 2 2 2 2 2 2 2 2 2 1 1 2 2 2 1 1 1 1 2 2 2 2 2 2 2 2 2 2 2 2 2 2 2 1 1 2 1 1 2 2 2 2 1 1 1 1 1 1 1 1 1 1 1 1 1 16 1 1 1 1 1 1 1 33 1 1 1 1 1 1 1 1 1 1 1 1 1 20 31 18 18 18 18 18 18
18 18 18 18 18 18 18 18 18 18 18 18 18 18 24 2 2 2 2 2 2 2 2 2 2 2 2 2 2 1 1 1 1 2 2 2 2 2 2 2 2 2 2 2 2 2 2 1 1 2 2 2 1 1 1 2 1 1 1 1 1 1 1 1 1 1 1 1 1 1 1 1 1 1 1 1 1 1 1 1 1 1 1 1 1 1 1 1 1 1 1 1 23 18 18 18 18 18 18 18
18 18 18 18 18 18 18 18 18 19 18 18 18 18 24 2 2 2 2 2 2 2 2 2 2 2 2 2 2 1 2 1 1 2 2 2 2 2 2 2 2 2 2 2 2 1 1 1 2 2 2 2 2 2 2 1 1 2 16 1 1 1 1 1 1 16 1 1 1 1 1 1 1 1 1 1 1 1 1 1 1 1 1 1 1 1 1 1 1 1 1 1 23 18 18 18 18 18 18 18
18 18 18 18 18 18 18 18 18 18 18 18 18 18 30 22 2 2 2 2 2 2 2 2 2 2 2 2 2 2 2 2 2 2 2 2 2 2 16 2 2 2 2 16 1 1 2 2 2 2 2 2 2 2 2 1 1 2 1 1 1 1 1 1 1 1 1 1 1 1 1 1 1 1 1 1 1 1 1 1 1 1 1 1 1 1 1 1 1 1 1 1 23 18 18 18 18 18 18 18
18 18 18 19 18 18 18 18 18 18 18 18 18 18 18 24 2 2 2 2 2 16 2 2 2 2 2 2 2 2 2 2 2 2 2 2 2 2 2 2 2 2 2 2 1 1 2 2 2 2 1 2 2 2 2 2 2 2 2 2 1 1 1 1 1 1 1 1 1 1 1 1 1 1 1 1 1 1 1 1 1 1 1 2 1 1 1 1 1 1 1 2 23 18 18 18 18 18 18 18
18 18 18 18 18 18 19 18 18 18 18 18 18 18 18 24 2 2 2 2 2 2 2 2 2 2 2 2 2 2 2 2 2 2 2 2 2 2 2 2 2 2 2 2 2 1 1 1 2 16 2 2 2 2 2 2 2 2 2 1 1 1 1 1 1 1 16 1 1 1 1 1 1 1 1 1 1 1 1 1 1 1 1 1 2 1 33 1 1 1 1 2 23 18 18 18 18 18 18 18
18 18 18 18 18 18 18 18 18 18 18 18 19 18 18 24 2 2 2 2 2 2 2 2 2 2 2 2 2 2 2 2 2 2 2 2 2 2 2 2 2 2 2 2 1 1 1 2 2 2 2 2 2 2 2 2 2 2 2 1 1 1 1 1 1 1 1 1 1 1 1 1 1 1 1 1 1 1 1 1 1 1 1 1 1 1 1 1 1 1 1 1 23 18 18 18 18 18 18 18
18 18 18 18 18 18 18 18 28 26 26 26 26 26 26 27 2 2 2 2 2 2 2 2 2 2 2 2 2 2 2 2 2 2 2 2 2 2 2 2 2 2 2 2 2 2 2 2 2 2 2 2 2 2 2 2 2 2 1 1 1 1 1 1 1 1 1 1 1 1 1 1 1 1 1 1 1 1 1 1 1 1 1 1 1 1 1 1 1 1 1 1 23 18 18 18 18 18 18 18
18 19 18 18 18 18 18 18 24 16 32 32 32 32 32 16 2 2 2 2 1 1 1 1 1 1 2 2 2 2 2 2 2 1 12 10 10 10 10 10 10 13 2 2 2 2 2 1 1 2 1 2 20 21 21 22 1 1 1 1 32 32 32 32 32 1 1 1 1 1 1 1 1 1 1 1 1 1 1 1 2 2 2 1 12 10 10 10 10 10 10 13 23 18 18 19 18 18 18 18
18 18 18 18 18 18 18 18 24 16 32 17 17 17 32 16 16 2 2 2 1 20 21 21 21 22 1 16 1 1 1 1 1 1 8 3 3 3 3 3 3 7 2 2 2 2 2 1 1 1 1 20 31 18 18 24 1 1 1 1 32 17 17 17 32 16 1 1 1 1 1 20 21 21 21 22 1 16 1 2 16 1 1 2 8 3 3 3 3 3 3 7 23 18 18 18 18 18 18 18
18 18 18 18 18 18 18 18 24 16 32 17 36 17 32 16 16 2 2 2 1 23 18 18 18 24 1 1 1 1 2 2 1 1 8 3 3 3 3 3 3 7 2 16 2 2 1 1 1 1 1 23 18 18 18 24 1 1 1 1 32 17 36 17 32 1 1 1 1 1 1 23 18 18 18 24 1 1 1 1 1 1 1 1 8 3 3 3 3 3 3 7 23 18 18 18 18 19 18 18
18 18 18 18 18 18 18 18 24 16 32 17 17 17 32 1 1 1 2 2 1 23 18 18 18 24 1 1 1 1 1 1 1 1 8 3 3 3 3 3 3 7 2 2 2 2 1 1 1 1 1 23 18 18 18 24 1 1 1 1 32 17 17 17 32 1 1 1 1 1 1 23 18 18 18 24 1 1 2 1 2 2 1 1 8 3 3 3 3 3 3 7 23 19 18 18 18 18 18 18
18 18 19 18 18 18 18 18 24 16 32 17 17 17 32 1 1 1 2 2 1 25 26 26 26 27 1 1 1 1 1 1 16 1 8 3 3 3 3 3 3 7 1 1 1 1 1 1 1 1 1 25 26 26 26 27 1 1 1 1 32 17 17 17 32 1 1 1 1 1 1 25 26 26 26 27 1 1 1 1 1 1 1 1 8 3 3 3 3 3 3 7 23 18 18 18 18 18 18 18
18 18 18 18 18 19 18 18 24 1 32 32 17 32 32 16 1 1 2 2 1 1 2 2 2 1 1 1 1 1 1 1 1 1 14 5 5 6 3 4 5 15 2 1 1 1 1 1 1 1 1 1 1 1 1 1 1 1 1 1 32 32 17 32 32 1 1 1 2 1 1 1 12 10 13 1 1 1 1 1 1 1 1 1 14 5 5 6 3 4 5 15 23 18 18 18 18 18 18 18
18 18 18 18 18 18 18 18 24 1 1 1 1 1 1 1 1 1 2 2 2 2 2 2 2 1 1 1 1 1 1 1 1 1 1 1 1 8 3 7 2 2 2 1 2 2 1 1 1 1 1 1 1 1 1 1 1 1 1 1 1 1 1 1 1 1 1 1 2 1 1 1 8 3 7 1 1 1 2 2 2 2 2 1 1 1 1 8 3 7 20 21 31 18 18 18 19 18 18 18
18 18 18 18 18 18 18 18 30 22 1 1 1 1 1 1 1 2 2 2 2 2 2 2 2 2 1 1 2 2 1 1 1 2 1 1 1 8 3 7 1 1 1 1 16 2 1 1 1 1 1 1 1 1 1 1 1 1 1 1 1 1 1 2 1 1 1 2 2 1 1 1 8 3 7 2 1 2 2 2 2 2 1 1 1 1 1 8 3 7 23 18 18 18 18 18 18 18 18 18
18 19 18 18 18 18 18 19 18 24 1 1 1 1 1 1 2 2 16 2 2 2 2 2 2 2 1 1 1 1 1 1 1 1 1 1 1 8 3 7 1 1 1 1 1 1 1 1 1 1 1 1 1 1 1 1 1 1 1 1 1 1 2 1 1 1 1 1 1 2 2 1 8 3 7 16 1 1 1 1 2 1 1 1 1 2 1 8 3 7 23 19 18 18 18 18 18 18 18 18
18 18 18 18 18 18 18 18 28 27 16 1 1 1 2 2 2 2 2 2 2 2 12 10 13 2 2 2 2 1 1 1 2 2 1 1 1 8 3 7 1 1 1 1 1 1 1 1 1 1 1 1 1 1 1 1 1 1 1 1 1 1 1 1 1 16 1 1 1 1 2 2 8 3 7 1 1 1 16 1 1 1 1 16 2 1 1 8 3 7 23 18 18 19 18 18 18 18 18 18
18 18 18 18 18 18 18 28 27 16 1 1 1 1 2 2 2 2 2 2 2 2 8 3 7 1 1 1 1 1 1 1 1 1 1 12 10 11 3 7 1 1 1 1 1 1 1 1 1 1 1 1 1 1 1 1 1 1 1 1 1 1 1 1 1 1 2 2 2 1 1 1 8 3 7 1 1 1 1 2 2 2 2 2 1 1 10 11 3 7 23 18 18 18 18 18 18 18 18 18
18 18 18 18 18 18 18 24 16 2 2 1 1 1 2 2 2 2 2 2 2 2 8 3 7 16 1 2 2 2 2 1 1 2 1 8 3 3 3 7 1 1 16 2 2 2 1 1 1 1 1 1 1 1 1 1 1 1 1 1 1 1 1 2 2 2 1 1 1 1 16 1 8 3 7 1 1 2 2 1 1 1 2 2 1 8 3 3 3 7 23 18 18 18 18 18 19 18 18 18
18 18 18 18 18 19 18 24 2 2 1 1 1 1 2 2 2 16 2 16 2 2 8 3 7 1 2 2 2 2 2 2 2 2 16 8 3 4 5 15 2 2 1 2 2 2 2 1 1 1 1 1 2 2 1 2 1 2 16 1 1 1 1 1 1 1 1 1 1 1 1 1 8 3 7 1 1 1 1 1 1 2 1 1 1 8 3 4 5 15 23 18 18 18 18 18 18 18 18 18
18 18 18 18 18 18 18 24 2 2 2 1 1 1 12 10 10 10 10 10 10 10 11 3 9 10 10 10 10 13 2 2 1 12 10 11 3 7 1 2 2 2 2 2 1 2 2 2 2 1 1 1 1 2 2 2 2 2 1 1 2 2 16 1 12 10 10 10 10 10 10 10 11 3 9 10 10 10 10 13 16 2 2 12 10 11 3 7 1 1 23 18 18 19 18 18 18 18 18 18
18 18 18 19 18 18 18 24 16 1 1 1 16 1 8 3 3 3 3 3 3 3 3 3 3 3 3 3 3 7 2 1 2 8 3 3 3 7 1 2 2 1 1 1 1 1 1 1 1 1 1 1 1 1 2 2 2 2 1 1 2 2 1 1 8 3 3 3 3 3 3 3 3 3 3 3 3 3 3 7 1 2 2 8 3 3 3 7 1 20 31 18 18 18 18 18 18 18 18 18
18 18 18 18 18 18 18 24 16 1 2 1 2 1 14 5 5 5 5 5 5 5 6 3 4 5 5 5 5 15 1 1 2 14 5 6 3 7 2 2 2 1 1 1 1 1 16 1 1 1 1 1 1 1 2 2 2 2 1 1 1 1 1 1 14 5 5 5 5 5 5 5 6 3 4 5 5 5 5 15 1 2 2 14 5 6 3 7 2 23 18 18 19 18 18 18 18 18 18 18
18 18 18 18 18 18 18 30 22 1 1 2 2 1 2 1 1 2 2 2 2 2 8 3 7 1 1 1 1 1 1 1 2 2 1 8 3 7 1 2 2 16 2 1 1 1 1 1 1 1 1 1 1 1 1 2 2 2 2 1 1 1 2 2 2 2 2 2 2 2 1 1 8 3 7 1 1 1 1 1 1 2 2 2 2 8 3 7 1 23 18 18 18 18 18 18 18 18 18 18
18 18 18 18 18 18 18 18 24 1 2 2 1 1 1 1 2 2 2 2 2 16 8 3 7 1 1 2 2 2 1 1 2 2 1 8 3 7 1 2 1 1 2 1 1 1 1 1 1 1 1 1 1 1 1 2 2 2 2 1 1 1 1 1 1 2 2 2 2 2 1 1 8 3 7 1 2 2 2 2 1 1 2 2 1 8 3 7 1 23 18 18 18 18 18 18 18 18 18 18
18 18 18 18 18 18 18 28 27 16 1 2 2 2 1 16 2 2 2 2 2 2 8 3 7 1 1 2 2 2 1 1 1 1 1 8 3 7 1 2 1 2 2 1 1 1 1 1 1 1 1 1 1 1 1 1 1 2 2 1 1 1 2 2 1 1 1 1 1 2 2 2 8 3 7 1 2 2 2 2 1 1 2 1 1 8 3 7 1 23 18 18 18 18 18 18 19 18 18 18
18 18 18 19 18 18 18 24 1 1 2 2 2 2 2 2 1 2 2 2 2 2 8 3 7 2 1 2 2 2 1 1 2 2 2 8 3 7 1 2 1 2 2 1 1 1 1 1 1 1 1 1 1 1 1 1 1 1 1 1 1 2 2 2 2 2 1 1 1 2 2 2 8 3 7 1 1 1 1 1 1 1 1 1 1 8 3 7 1 23 18 18 18 18 18 18 18 18 18 18
18 18 18 18 18 18 18 24 16 1 1 1 2 1 2 2 1 1 1 2 2 2 8 3 7 2 1 1 2 2 16 2 2 2 2 8 3 7 1 2 1 1 1 1 1 16 1 1 1 1 1 1 1 1 1 1 1 1 1 1 1 2 1 2 2 1 1 1 2 2 2 2 8 3 7 1 1 2 2 2 2 1 2 1 1 8 3 7 1 23 18 18 18 18 18 18 18 18 18 18
18 18 18 18 18 18 18 24 1 1 1 1 1 1 1 16 1 2 1 2 2 2 8 3 7 1 1 2 2 2 2 2 2 2 2 8 3 7 1 2 2 1 2 2 2 1 2 2 2 2 2 2 2 2 2 2 2 2 1 1 1 1 1 1 2 1 1 2 2 2 2 2 8 3 7 1 2 1 16 1 1 2 2 1 1 8 3 7 1 23 18 18 19 18 18 18 18 18 18 18
18 18 19 18 18 18 18 24 1 1 1 1 2 1 1 1 1 2 2 2 2 2 8 3 7 1 1 1 1 1 1 2 2 2 1 14 5 15 1 2 2 2 2 2 2 2 2 2 2 2 2 2 2 2 2 2 2 2 1 1 1 2 1 1 2 1 1 1 1 1 2 2 8 3 7 1 1 1 1 1 1 1 1 1 2 14 5 15 1 23 18 18 18 18 18 18 18 18 18 18
18 18 18 18 18 18 18 24 16 1 1 2 2 1 1 1 1 1 1 1 2 2 8 3 7 1 1 1 1 1 1 1 1 1 16 1 1 2 2 2 2 2 2 2 2 2 2 2 2 2 2 2 2 2 2 2 2 2 16 1 1 1 1 1 1 1 2 2 1 2 2 2 8 3 7 2 1 2 2 2 1 1 1 1 1 1 1 1 20 31 18 18 18 18 18 18 18 18 18 18
18 18 18 18 18 18 19 30 22 16 1 2 1 1 1 1 1 1 2 2 2 2 8 3 7 2 2 2 2 2 2 2 2 2 2 1 1 1 2 2 2 2 2 2 2 2 2 2 2 2 2 2 2 2 2 2 2 2 2 1 1 2 1 1 2 2 16 2 1 2 2 2 8 3 7 2 2 2 2 1 1 2 1 1 1 1 1 1 23 18 19 18 18 18 18 18 18 18 18 18
18 18 18 18 18 18 18 18 24 1 1 1 1 2 2 2 2 1 1 1 2 2 8 3 7 2 2 2 2 2 2 2 2 2 2 1 1 1 2 2 2 2 2 2 2 2 2 2 2 2 2 2 2 2 2 2 2 2 1 1 2 2 1 2 2 1 2 2 1 1 2 2 8 3 7 1 2 2 2 1 1 1 1 1 1 1 1 1 23 18 18 18 18 18 18 18 18 19 18 18
18 18 18 18 18 18 18 18 24 1 1 1 1 1 1 1 2 2 2 1 2 2 14 5 15 2 2 2 2 2 2 2 2 2 2 2 1 2 2 2 2 2 2 2 2 2 2 2 2 2 2 2 2 2 2 2 2 2 1 2 1 2 2 2 2 2 2 2 16 1 2 2 8 3 7 1 2 2 2 1 2 2 1 1 1 1 1 2 23 18 18 18 18 18 18 18 18 18 18 18
18 18 18 18 19 18 18 18 24 16 1 1 2 2 2 2 1 1 1 1 1 2 2 2 2 2 2 2 2 2 2 2 2 2 2 1 2 1 2 2 2 2 2 2 2 2 2 2 2 2 2 2 2 2 2 2 2 2 1 2 2 2 2 2 2 2 2 2 2 1 2 1 8 3 7 1 1 2 1 1 1 1 1 2 1 1 1 1 23 18 18 18 18 18 18 18 18 18 18 18
18 18 18 18 18 18 18 28 27 1 1 1 1 1 1 1 1 2 2 2 16 2 2 2 2 2 2 2 2 2 2 2 2 2 2 2 2 2 2 2 2 2 2 2 2 2 2 2 2 2 2 2 2 2 2 2 2 2 1 1 2 2 2 16 2 2 2 2 2 1 1 16 14 5 15 16 1 1 1 2 2 1 1 1 1 1 1 1 25 29 18 18 18 18 18 18 18 18 18 18
18 18 18 18 18 18 18 24 16 2 2 2 2 2 2 2 1 1 2 2 1 1 1 2 1 2 1 2 2 2 1 1 1 1 2 1 1 2 2 2 2 2 2 2 2 2 2 2 2 2 2 2 2 2 2 2 2 1 1 1 2 2 2 2 2 1 2 2 2 2 1 1 1 1 1 2 2 1 1 2 2 1 2 2 1 1 1 1 1 25 29 18 18 19 18 18 18 18 18 18
18 18 18 18 18 18 18 24 2 1 1 1 2 2 2 2 2 1 2 2 1 1 1 2 1 1 2 2 2 1 1 1 2 2 1 1 1 2 1 2 2 2 2 2 2 2 2 2 2 2 2 2 2 2 2 2 20 22 2 2 2 2 2 1 1 1 1 2 2 2 2 2 1 2 2 1 2 1 1 1 1 1 2 1 1 2 1 1 1 1 23 18 18 18 18 18 18 18 18 18
18 18 18 18 18 18 18 24 1 1 1 1 1 2 2 16 1 1 1 1 1 1 1 1 1 1 1 2 16 16 1 1 2 2 1 1 1 1 1 1 2 2 2 2 2 2 2 2 2 2 2 2 2 2 2 20 31 24 1 1 1 1 1 2 1 1 2 2 2 2 1 1 2 2 1 1 2 2 1 1 1 2 2 1 1 1 1 1 1 1 23 18 18 18 18 18 18 18 18 18
18 18 18 18 18 18 18 24 1 1 33 16 1 2 1 1 1 1 1 1 1 1 1 1 1 1 2 2 1 2 2 1 1 1 1 1 1 1 1 2 2 2 2 2 2 2 2 2 2 2 20 2 2 20 21 31 18 24 1 1 1 1 2 2 1 2 1 2 2 1 1 1 1 1 1 1 2 2 2 1 1 1 1 1 1 1 1 16 1 2 23 18 18 18 18 18 18 18 18 18
18 18 18 18 18 19 18 24 1 1 1 1 1 1 1 1 1 1 1 1 2 1 1 1 1 1 1 1 2 1 1 1 1 1 16 1 1 1 1 1 2 2 2 2 2 2 2 2 2 2 23 21 21 31 18 18 18 24 1 1 1 1 1 1 1 1 1 2 2 2 2 1 1 2 1 2 1 1 1 1 1 1 1 1 16 1 1 1 1 1 23 18 18 18 18 18 18 18 18 18
18 18 18 18 18 18 18 24 1 1 1 1 1 1 1 20 21 21 22 1 1 1 1 1 1 1 1 20 21 21 22 1 1 1 1 1 1 1 1 1 2 2 2 2 2 2 2 2 2 20 31 18 18 18 18 18 18 24 1 1 1 1 1 1 1 20 21 21 22 1 2 2 2 1 1 1 1 20 21 21 22 1 1 1 1 1 1 1 1 1 23 18 18 18 18 18 18 18 18 18
18 19 18 18 18 18 18 24 16 1 16 1 1 1 20 31 18 18 30 22 1 1 1 1 1 1 20 31 18 18 24 1 1 1 1 1 1 1 1 1 2 2 2 2 2 2 2 2 20 31 18 19 18 18 18 18 18 24 16 1 1 1 1 16 20 31 18 18 30 22 1 1 1 1 1 1 20 31 18 18 24 1 1 16 1 1 16 1 1 1 23 18 18 18 18 18 19 18 18 18
18 18 18 18 18 18 18 30 21 21 21 21 21 21 31 18 18 18 18 30 21 21 21 21 21 21 31 18 18 18 30 22 1 1 1 1 1 1 20 21 2 2 2 2 2 2 2 20 31 18 18 18 18 18 18 18 18 30 21 21 21 21 21 21 31 18 18 18 18 30 21 21 21 21 21 21 31 18 18 18 30 22 1 1 1 1 1 1 20 21 31 18 19 18 18 18 18 18 18 18
18 18 18 18 18 18 18 18 18 18 18 18 18 18 19 18 18 18 18 18 18 18 18 18 18 18 18 18 19 18 18 30 21 21 21 21 21 21 31 18 21 21 21 21 21 21 21 31 18 18 18 18 18 18 18 18 18 18 18 18 18 18 18 18 19 18 18 18 18 18 18 18 18 18 18 18 18 18 19 18 18 30 21 21 21 21 21 21 31 18 18 18 18 18 18 18 18 18 18 18
18 18 18 18 19 18 18 18 18 18 18 18 18 18 18 18 18 18 18 18 18 18 18 18 18 18 18 18 18 18 18 18 19 18 18 18 18 18 18 19 18 18 18 18 18 18 18 18 18 18 18 18 18 18 19 18 18 18 18 18 18 18 18 18 18 18 18 18 18 18 18 18 18 18 18 18 18 18 18 18 18 18 19 18 18 18 18 18 18 19 18 18 18 18 18 18 18 18 18 18
18 18 18 18 18 18 18 18 18 19 18 18 18 18 18 18 18 18 18 18 18 18 18 19 18 18 18 18 18 18 18 18 18 18 18 18 18 18 18 18 18 18 18 18 18 19 18 18 18 18 18 18 18 18 18 18 18 18 18 19 18 18 18 18 18 18 18 18 18 18 18 18 18 19 18 18 18 18 18 18 18 18 18 18 18 18 18 18 18 18 18 18 18 18 18 19 18 18 18 18
18 18 18 18 18 18 18 18 18 18 18 18 18 18 18 18 18 18 18 18 18 18 18 18 18 18 18 18 18 18 18 18 18 18 18 18 18 18 18 18 18 18 18 18 18 18 18 18 18 18 18 18 18 18 18 18 18 18 18 18 18 18 18 18 18 18 18 18 18 18 18 18 18 18 18 18 18 18 18 18 18 18 18 18 18 18 18 18 18 18 18 18 18 18 18 18 18 18 18 18
18 18 18 18 18 18 18 18 18 18 18 18 18 18 18 18 18 18 18 18 18 18 18 18 18 18 18 18 18 18 18 18 18 18 18 18 18 18 18 18 18 18 18 18 18 18 18 18 18 18 18 18 18 18 18 18 18 18 18 18 18 18 18 18 18 18 18 18 18 18 18 18 18 18 18 18 18 18 18 18 18 18 18 18 18 18 18 18 18 18 18 18 18 18 18 18 18 18 18 18
18 18 18 18 18 18 18 18 18 18 18 18 18 18 18 18 18 18 18 18 18 18 18 18 18 18 18 18 18 18 18 18 18 18 18 18 18 18 18 18 18 18 18 18 18 18 18 18 18 18 18 18 18 18 18 18 18 18 18 18 18 18 18 18 18 18 18 18 18 18 18 18 18 18 18 18 18 18 18 18 18 18 18 18 18 18 18 18 18 18 18 18 18 18 18 18 18 18 18 18